1111111111111111111111111111111111111
1E0010000C0000000000000C0000000000001
110100C001000000100000000000C000001C1
100C011010C00001010000010000000000101
100010P1C00000C1000000010000000000101
1000101100000001010000010000000000101
1000000100000001010000000000000000101
10001011010000010C0000000011110000101
1000000100100001000010000000000100101
1000101101000001000C00000011000000101
1000000100100001000010000000000100101
1000101101000001000000000000000000101
10000001001000C1000010000100000100101
1000101100010001C0001C000000000000101
1000000000001001000011110000100000101
10111011C00001010000000C0000100000101
100C000100000C110000000000000100001C1
1111111111111111111111111111111111111