1111111111111111111111111111111111111111
100010100000000C00000C000000000000000001
111001010010000010100100000C000010100001
1P10100010101010001001000000000010000101
101000000C00C0000000000000000000000000C1
1000100010101010001000000001000000011101
1010100000101000001000000C00000000010101
10001000100010000010010000000000000101C1
1000000010001000000001000C0000000001E101
1000100010101010001000000001000000010101
1000100000101010001000000001000000010101
1000100010101010001000000000000000010101
10001000100010C0000000C00000000000010101
1000100010001010001000000001000000011101
10001000C0001010000000000001000000000001
1111111111111111111111111111111111111111
