11111111111111111111
1E0100000C0000C00001
101000C0000000001001
100C000000C00001P00111
10000000C00000C10C0001
1111111111111111111111
